1111111111111111111
1000000000000000001
1011110111111111101
10C00000000E00000C1
1010110110111011101
100010000P000000001
1010110111111011101
10C00000000000000C1
1010110110111011101
1111111111111111111
