111111111111
100000011111
1E010011C111
10001000P111
111111111111