111111111111111111111111
100000000000C00000000001
101111011111011111111101
10C0000100000100000000C1
101011110111011101110101
100010000C000000C0000001
1E0110111111111011101101
101010000000000000000101
100C01011101111101100C01
101000100C000C0001000101
100011101111011110111001
1010000000P0000000000101
100111110111111111110001
100000000C000C0000000001
111111111111111111111111