11111111111111111111
100000C00C000C000001
10111101111111111001
10C00C00000E0C000C01
101011011011101110C1
100010000P0C00000001
10101101111110111001
10101101101110111001
10C000C0000C00000C01
10C00000C00C00000C01
11111111111111111111
