111111111111111111
1E0000001111000011
10001C001CCCC00001
10001C001000000001
10001C001000000001
100011111111100001
10000000100C100001
10000000100C100001
1000CCCC100C100001
10001111100C100001
10000000000000P001
111111111111111111