1111111111
1000000001
100000E001
111C0000C1
10CP000001
1111111111
