1111111111
1000000001
100000E001
111C0000C1
10P0000001
1111111111