111111111111111111
1E10P0000000000001
1101C0011111000011
10001C001CCCC00001
10001C001000000001
10001C001000000001
100011111111100001
10000000100C100001
10000000100C100001
1000CCCC100C100001
10001111100C100001
100000000000000001
111111111111111111