11111111111111111111
10000000000000000011
10111101111111111011
10C00000000E00000C11
10101101101110111011
100010000P0000000011
10101101111110111011
10101101101110111011
10C00000000000000C11
10C00000000000000C11
11111111111111111111
