111111111111111
10C0X00C000C001
111001110C001C1
1P000C0001001C1
110111111111001
10C00111C10CE11
111100CC0001X11
111111111111111
