1111111111
100C000101
1E010C0101
100C0000P1
1111111111
